1111111111111
10F1C000000C1
100F011111001
1P000GE00C001
1111111111111