1111111111111
1001C0000F0C1
100F011111001
1P0000E00C001
1111111111111